Source,Destination,Source Coordinates,Destination Coordinates,Total Distance (m),Total Duration (seconds),Onroad Duration (seconds),Charging Duration (seconds),Number of Stops,Distance (km)
Agra,Delhi,"27.1752554,78.0098161","28.6273928,77.1716954",209076,16712,14513,2199,1,209.076
Agra,Jaipur,"27.1752554,78.0098161","26.9154576,75.8189817",398610,27690,21894,5796,2,398.61
Ahmedabad,Amritsar,"23.0216238,72.5797068","31.6343083,74.8736788",1378073,107525,73187,34338,11,1378.073
Ahmedabad,Belgaum,"23.0216238,72.5797068","15.8572666,74.5069343",1002238,72132,52346,19786,7,1002.238
Ahmedabad,Bhavnagar,"23.0216238,72.5797068","21.7718836,72.1416449",174370,13090,11624,1466,1,174.37
Ahmedabad,Bhubaneswar,"23.0216238,72.5797068","20.2602964,85.8394521",5294082,455541,394714,60827,22,5294.082
Ahmedabad,Chandigarh,"23.0216238,72.5797068","30.7334421,76.7797143",1168055,92814,62773,30041,10,1168.055
Ahmedabad,Chennai,"23.0216238,72.5797068","13.0836939,80.270186",1848257,140679,95093,45586,14,1848.257
Ahmedabad,Coimbatore,"23.0216238,72.5797068","11.0018115,76.9628425",1889247,140286,94165,46121,14,1889.247
Ahmedabad,Dehradun,"23.0216238,72.5797068","30.3255646,78.0436813",1182222,95933,65419,30514,10,1182.222
Ahmedabad,Delhi,"23.0216238,72.5797068","28.6273928,77.1716954",923123,77056,51724,25332,8,923.123
Ahmedabad,Goa,"23.0216238,72.5797068","15.3004543,74.0855134",1115866,85513,62497,23016,8,1115.866
Ahmedabad,Hubli,"23.0216238,72.5797068","15.3518378,75.1379848",1097533,79222,57032,22190,8,1097.533
Ahmedabad,Hyderabad,"23.0216238,72.5797068","17.360589,78.4740613",1236098,94693,65468,29225,10,1236.098
Ahmedabad,Jaipur,"23.0216238,72.5797068","26.9154576,75.8189817",662066,55720,35686,20034,6,662.066
Ahmedabad,Jammu,"23.0216238,72.5797068","32.7185614,74.8580917",1514581,118155,79907,38248,12,1514.581
Ahmedabad,Jodhpur,"23.0216238,72.5797068","26.2967719,73.0351433",470024,34995,24900,10095,3,470.024
Ahmedabad,Kannur,"23.0216238,72.5797068","11.8763836,75.3737973",1772987,139540,94739,44801,13,1772.987
Ahmedabad,Keshod,"23.0216238,72.5797068","21.31486295,70.26789366226589",359840,28601,22310,6291,3,359.84
Ahmedabad,Kochi,"23.0216238,72.5797068","9.9674277,76.2454436",2087130,158448,106603,51845,16,2087.13
Ahmedabad,Kolkata,"23.0216238,72.5797068","22.5726459,88.3638953",4822836,411024,362771,48253,18,4822.836
Ahmedabad,Mumbai,"23.0216238,72.5797068","19.08157715,72.88662753964906",526218,37476,27883,9593,3,526.218
Ahmedabad,Nagpur,"23.0216238,72.5797068","21.1498134,79.0820556",1681985,129125,86892,42233,12,1681.985
Ahmedabad,Porbandar,"23.0216238,72.5797068","21.6409,69.611",428012,35000,26729,8271,3,428.012
Ahmedabad,Pune,"23.0216238,72.5797068","18.521428,73.8544541",667761,47117,35615,11502,4,667.761
Ahmedabad,Raipur,"23.0216238,72.5797068","21.2380912,81.6336993",1969518,153604,103236,50368,14,1969.518
Ahmedabad,Ranchi,"23.0216238,72.5797068","23.3700501,85.3250387",5254594,450940,391177,59763,21,5254.594
Ahmedabad,Udaipur,"23.0216238,72.5797068","24.578721,73.6862571",262424,20490,14994,5496,2,262.424
Ahmedabad,Vadodara,"23.0216238,72.5797068","22.2973142,73.1942567",112101,7563,6902,661,1,112.101
Amritsar,Ahmedabad,"31.6343083,74.8736788","23.0216238,72.5797068",1401505,110675,73627,37048,12,1401.505
Amritsar,Chennai,"31.6343083,74.8736788","13.0836939,80.270186",3236914,254745,170271,84474,27,3236.914
Amritsar,Dehradun,"31.6343083,74.8736788","30.3255646,78.0436813",453838,32796,23857,8939,2,453.838
Amritsar,Delhi,"31.6343083,74.8736788","28.6273928,77.1716954",462853,33338,24399,8939,2,462.853
Amritsar,Goa,"31.6343083,74.8736788","15.3004543,74.0855134",2505715,198397,135822,62575,21,2505.715
Amritsar,Hyderabad,"31.6343083,74.8736788","17.360589,78.4740613",2624651,207172,137673,69499,23,2624.651
Amritsar,Jaipur,"31.6343083,74.8736788","26.9154576,75.8189817",717372,50026,35330,14696,4,717.372
Amritsar,Mumbai,"31.6343083,74.8736788","19.08157715,72.88662753964906",1921770,149577,99696,49881,16,1921.77
Bagdogra,Bagdogra,"26.6988847,88.3200303","26.6988847,88.3200303",0,0,0,0,0,0.0
Belgaum,Ahmedabad,"15.8572666,74.5069343","23.0216238,72.5797068",996659,74285,53344,20941,7,996.659
Belgaum,Hyderabad,"15.8572666,74.5069343","17.360589,78.4740613",632109,50910,34076,16834,5,632.109
Belgaum,Kadapa,"15.8572666,74.5069343","14.4752936,78.8216861",704899,64800,41397,23403,5,704.899
Belgaum,Mumbai,"15.8572666,74.5069343","19.08157715,72.88662753964906",480566,35036,26020,9016,3,480.566
Belgaum,Mysore,"15.8572666,74.5069343","12.3051828,76.6553609",635413,49783,30610,19173,5,635.413
Belgaum,Pune,"15.8572666,74.5069343","18.521428,73.8544541",336232,25242,18861,6381,2,336.232
Belgaum,Tirupati,"15.8572666,74.5069343","13.6316368,79.4231711",776554,58155,37370,20785,7,776.554
Bengaluru,Agra,"12.9767936,77.590082","27.1752554,78.0098161",2549332,201356,133164,68192,20,2549.332
Bengaluru,Amritsar,"12.9767936,77.590082","31.6343083,74.8736788",2863521,221030,146771,74259,22,2863.521
Bengaluru,Belgaum,"12.9767936,77.590082","15.8572666,74.5069343",513418,42033,25007,17026,4,513.418
Bengaluru,Bhubaneswar,"12.9767936,77.590082","20.2602964,85.8394521",3866799,351207,329394,21813,8,3866.799
Bengaluru,Calicut,"12.9767936,77.590082","11.2450558,75.7754716",401471,36411,28664,7747,3,401.471
Bengaluru,Chandigarh,"12.9767936,77.590082","30.7334421,76.7797143",2653260,207613,137494,70119,20,2653.26
Bengaluru,Chennai,"12.9767936,77.590082","13.0836939,80.270186",339876,27478,20982,6496,2,339.876
Bengaluru,Coimbatore,"12.9767936,77.590082","11.0018115,76.9628425",365428,27003,19776,7227,2,365.428
Bengaluru,Dehradun,"12.9767936,77.590082","30.3255646,78.0436813",2677921,211266,140533,70733,22,2677.921
Bengaluru,Delhi,"12.9767936,77.590082","28.6273928,77.1716954",2408411,193787,128288,65499,19,2408.411
Bengaluru,Goa,"12.9767936,77.590082","15.3004543,74.0855134",573401,49310,32021,17289,4,573.401
Bengaluru,Gwalior,"12.9767936,77.590082","26.2037247,78.1573628",2663947,209872,138890,70982,21,2663.947
Bengaluru,Hubli,"12.9767936,77.590082","15.3518378,75.1379848",417560,32089,19760,12329,3,417.56
Bengaluru,Hyderabad,"12.9767936,77.590082","17.360589,78.4740613",568279,38808,27230,11578,4,568.279
Bengaluru,Jaipur,"12.9767936,77.590082","26.9154576,75.8189817",2151502,174009,112628,61381,17,2151.502
Bengaluru,Jodhpur,"12.9767936,77.590082","26.2967719,73.0351433",1977262,150706,101588,49118,14,1977.262
Bengaluru,Kannur,"12.9767936,77.590082","11.8763836,75.3737973",325461,30155,22986,7169,3,325.461
Bengaluru,Kochi,"12.9767936,77.590082","9.9674277,76.2454436",561259,41268,29826,11442,3,561.259
Bengaluru,Kolhapur,"12.9767936,77.590082","16.7028412,74.2405329",619367,48221,29537,18684,4,619.367
Bengaluru,Kolkata,"12.9767936,77.590082","22.5726459,88.3638953",3399883,306154,297582,8572,5,3399.883
Bengaluru,Madurai,"12.9767936,77.590082","9.9261153,78.1140983",482912,39606,27791,11815,3,482.912
Bengaluru,Mangalore,"12.9767936,77.590082","12.8698101,74.8430082",394016,38622,26831,11791,3,394.016
Bengaluru,Mumbai,"12.9767936,77.590082","19.08157715,72.88662753964906",990382,75161,49288,25873,7,990.382
Bengaluru,Mysore,"12.9767936,77.590082","12.3051828,76.6553609",146987,10535,8931,1604,1,146.987
Bengaluru,Nagpur,"12.9767936,77.590082","21.1498134,79.0820556",1082268,76587,52882,23705,7,1082.268
Bengaluru,Pondicherry,"12.9767936,77.590082","10.91564885,79.80694879844232",501660,45762,32958,12804,3,501.66
Bengaluru,Port Blair,"12.9767936,77.590082","11.6645348,92.7390448",1860337,166501,158516,7985,3,1860.337
Bengaluru,Pune,"12.9767936,77.590082","18.521428,73.8544541",844361,64931,40812,24119,6,844.361
Bengaluru,Raipur,"12.9767936,77.590082","21.2380912,81.6336993",1369801,102276,69672,32604,9,1369.801
Bengaluru,Rajahmundry,"12.9767936,77.590082","17.0050454,81.7804732",827424,63933,43367,20566,6,827.424
Bengaluru,Ranchi,"12.9767936,77.590082","23.3700501,85.3250387",3831497,346649,325470,21179,8,3831.497
Bengaluru,Thiruvananthapuram,"12.9767936,77.590082","8.4882267,76.947551",755665,58069,41295,16774,4,755.665
Bengaluru,Tiruchirappalli,"12.9767936,77.590082","10.804973,78.6870296",342957,28309,21372,6937,2,342.957
Bengaluru,Tirupati,"12.9767936,77.590082","13.6316368,79.4231711",256475,19063,14681,4382,2,256.475
Bengaluru,Tuticorin,"12.9767936,77.590082","8.8052602,78.1452745",631768,51226,35334,15892,4,631.768
Bengaluru,Udaipur,"12.9767936,77.590082","24.578721,73.6862571",1751860,136189,89712,46477,13,1751.86
Bengaluru,Vadodara,"12.9767936,77.590082","22.2973142,73.1942567",1391646,106803,72083,34720,10,1391.646
Bengaluru,Vijayawada,"12.9767936,77.590082","16.5087573,80.6185089",670407,51196,34880,16316,5,670.407
Bengaluru,Visakhapatnam,"12.9767936,77.590082","17.7231276,83.3012842",1039041,84956,56805,28151,8,1039.041
Bhatinda,Delhi,"30.25,75.0","28.6273928,77.1716954",419102,28944,21829,7115,2,419.102
Bhatinda,Jammu,"30.25,75.0","32.7185614,74.8580917",449518,35207,25119,10088,2,449.518
Bhavnagar,Ahmedabad,"21.7718836,72.1416449","23.0216238,72.5797068",293664,22922,18510,4412,3,293.664
Bhavnagar,Mumbai,"21.7718836,72.1416449","19.08157715,72.88662753964906",435177,35995,26729,9266,4,435.177
Bhopal,Agra,"23.2584857,77.401989","27.1752554,78.0098161",1634528,131382,88307,43075,13,1634.528
Bhopal,Ahmedabad,"23.2584857,77.401989","23.0216238,72.5797068",587110,47385,34069,13316,4,587.11
Bhopal,Bengaluru,"23.2584857,77.401989","12.9767936,77.590082",1920635,148998,101317,47681,15,1920.635
Bhopal,Bhopal,"23.2584857,77.401989","23.2584857,77.401989",0,0,0,0,0,0.0
Bhopal,Chennai,"23.2584857,77.401989","13.0836939,80.270186",2257493,178576,123242,55334,17,2257.493
Bhopal,Delhi,"23.2584857,77.401989","28.6273928,77.1716954",1493607,123405,82669,40736,12,1493.607
Bhopal,Hyderabad,"23.2584857,77.401989","17.360589,78.4740613",1644145,129475,89554,39921,13,1644.145
Bhopal,Jaipur,"23.2584857,77.401989","26.9154576,75.8189817",1231464,105726,69868,35858,10,1231.464
Bhopal,Kolkata,"23.2584857,77.401989","22.5726459,88.3638953",5224963,447901,388528,59373,21,5224.963
Bhopal,Mumbai,"23.2584857,77.401989","19.08157715,72.88662753964906",939140,73912,52205,21707,6,939.14
Bhopal,Nagpur,"23.2584857,77.401989","21.1498134,79.0820556",2083878,164005,111205,52800,15,2083.878
Bhopal,Pune,"23.2584857,77.401989","18.521428,73.8544541",1077768,83584,60907,22677,7,1077.768
Bhopal,Udaipur,"23.2584857,77.401989","24.578721,73.6862571",831822,67989,47220,20769,6,831.822
Bhubaneswar,Ahmedabad,"20.2602964,85.8394521","23.0216238,72.5797068",5305648,459480,398537,60943,19,5305.648
Bhubaneswar,Bengaluru,"20.2602964,85.8394521","12.9767936,77.590082",3867474,353467,330269,23198,8,3867.474
Bhubaneswar,Chennai,"20.2602964,85.8394521","13.0836939,80.270186",3531713,321299,307811,13488,5,3531.713
Bhubaneswar,Delhi,"20.2602964,85.8394521","28.6273928,77.1716954",6208906,536846,448702,88144,27,6208.906
Bhubaneswar,Hyderabad,"20.2602964,85.8394521","17.360589,78.4740613",4036037,362967,331852,31115,9,4036.037
Bhubaneswar,Kochi,"20.2602964,85.8394521","9.9674277,76.2454436",4264373,382426,348004,34422,11,4264.373
Bhubaneswar,Kolkata,"20.2602964,85.8394521","22.5726459,88.3638953",480656,43589,32209,11380,2,480.656
Bhubaneswar,Mumbai,"20.2602964,85.8394521","19.08157715,72.88662753964906",4779640,419068,370164,48904,15,4779.64
Bhubaneswar,Nagpur,"20.2602964,85.8394521","21.1498134,79.0820556",4535361,399357,353513,45844,12,4535.361
Bhubaneswar,Pune,"20.2602964,85.8394521","18.521428,73.8544541",4629956,406946,360359,46587,14,4629.956
Bhubaneswar,Raipur,"20.2602964,85.8394521","21.2380912,81.6336993",4823909,427026,372029,54997,15,4823.909
Bhubaneswar,Ranchi,"20.2602964,85.8394521","23.3700501,85.3250387",826637,82364,58186,24178,5,826.637
Bhubaneswar,Visakhapatnam,"20.2602964,85.8394521","17.7231276,83.3012842",3397644,308471,295226,13245,5,3397.644
Calicut,Chennai,"11.2450558,75.7754716","13.0836939,80.270186",712482,59008,40331,18677,5,712.482
Calicut,Delhi,"11.2450558,75.7754716","28.6273928,77.1716954",2754995,224832,149485,75347,22,2754.995
Calicut,Hyderabad,"11.2450558,75.7754716","17.360589,78.4740613",961384,76841,53614,23227,7,961.384
Calicut,Kannur,"11.2450558,75.7754716","11.8763836,75.3737973",91393,8685,8685,0,0,91.393
Calicut,Kochi,"11.2450558,75.7754716","9.9674277,76.2454436",169279,18755,14878,3877,2,169.279
Calicut,Mumbai,"11.2450558,75.7754716","19.08157715,72.88662753964906",1325237,112009,75806,36203,10,1325.237
Chandigarh,Ahmedabad,"30.7334421,76.7797143","23.0216238,72.5797068",1174271,91144,62082,29062,10,1174.271
Chandigarh,Chennai,"30.7334421,76.7797143","13.0836939,80.270186",3006241,231970,155108,76862,24,3006.241
Chandigarh,Delhi,"30.7334421,76.7797143","28.6273928,77.1716954",256354,20160,16283,3877,3,256.354
Chandigarh,Goa,"30.7334421,76.7797143","15.3004543,74.0855134",2276137,177730,122881,54849,18,2276.137
Chandigarh,Hyderabad,"30.7334421,76.7797143","17.360589,78.4740613",2396516,186554,125803,60751,20,2396.516
Chandigarh,Jaipur,"30.7334421,76.7797143","26.9154576,75.8189817",512838,34437,26363,8074,3,512.838
Chandigarh,Jammu,"30.7334421,76.7797143","32.7185614,74.8580917",375733,28113,20950,7163,3,375.733
Chandigarh,Kolkata,"30.7334421,76.7797143","22.5726459,88.3638953",5977090,501692,422321,79371,28,5977.09
Chandigarh,Mumbai,"30.7334421,76.7797143","19.08157715,72.88662753964906",1686324,128882,87590,41292,13,1686.324
Chandigarh,Pune,"30.7334421,76.7797143","18.521428,73.8544541",1828884,138537,95314,43223,14,1828.884
Chandigarh,Shimla,"30.7334421,76.7797143","31.1041526,77.1709729",109775,12525,9958,2567,1,109.775
Chennai,Ahmedabad,"13.0836939,80.270186","23.0216238,72.5797068",1836232,140930,96543,44387,14,1836.232
Chennai,Amritsar,"13.0836939,80.270186","31.6343083,74.8736788",3205924,248320,166166,82154,25,3205.924
Chennai,Bengaluru,"13.0836939,80.270186","12.9767936,77.590082",337241,28543,20840,7703,2,337.241
Chennai,Bhubaneswar,"13.0836939,80.270186","20.2602964,85.8394521",3527699,320696,307125,13571,6,3527.699
Chennai,Calicut,"13.0836939,80.270186","11.2450558,75.7754716",720057,59712,41031,18681,6,720.057
Chennai,Chandigarh,"13.0836939,80.270186","30.7334421,76.7797143",2995722,232852,155378,77474,23,2995.722
Chennai,Coimbatore,"13.0836939,80.270186","11.0018115,76.9628425",537445,42864,28185,14679,5,537.445
Chennai,Delhi,"13.0836939,80.270186","28.6273928,77.1716954",2744849,215666,143871,71795,21,2744.849
Chennai,Goa,"13.0836939,80.270186","15.3004543,74.0855134",909718,76977,52098,24879,7,909.718
Chennai,Hubli,"13.0836939,80.270186","15.3518378,75.1379848",752932,57588,38247,19341,6,752.932
Chennai,Hyderabad,"13.0836939,80.270186","17.360589,78.4740613",632273,49493,34132,15361,5,632.273
Chennai,Jaipur,"13.0836939,80.270186","26.9154576,75.8189817",2489655,199441,131950,67491,21,2489.655
Chennai,Jodhpur,"13.0836939,80.270186","26.2967719,73.0351433",2309574,179005,122821,56184,18,2309.574
Chennai,Kadapa,"13.0836939,80.270186","14.4752936,78.8216861",266806,24571,19539,5032,2,266.806
Chennai,Kannur,"13.0836939,80.270186","11.8763836,75.3737973",657870,55149,41580,13569,5,657.87
Chennai,Kochi,"13.0836939,80.270186","9.9674277,76.2454436",733698,57359,38681,18678,6,733.698
Chennai,Kolkata,"13.0836939,80.270186","22.5726459,88.3638953",3060572,278827,277627,1200,2,3060.572
Chennai,Madurai,"13.0836939,80.270186","9.9261153,78.1140983",467444,35501,24439,11062,3,467.444
Chennai,Mangalore,"13.0836939,80.270186","12.8698101,74.8430082",731397,65089,46160,18929,6,731.397
Chennai,Mumbai,"13.0836939,80.270186","19.08157715,72.88662753964906",1326907,104077,70974,33103,11,1326.907
Chennai,Mysore,"13.0836939,80.270186","12.3051828,76.6553609",478359,37500,28195,9305,4,478.359
Chennai,Nagpur,"13.0836939,80.270186","21.1498134,79.0820556",1144050,89875,58715,31160,9,1144.05
Chennai,Port Blair,"13.0836939,80.270186","11.6645348,92.7390448",1521218,139282,138682,600,1,1521.218
Chennai,Pune,"13.0836939,80.270186","18.521428,73.8544541",1179902,93678,62156,31522,9,1179.902
Chennai,Raipur,"13.0836939,80.270186","21.2380912,81.6336993",1431583,114622,74673,39949,11,1431.583
Chennai,Rajahmundry,"13.0836939,80.270186","17.0050454,81.7804732",611700,45763,31331,14432,5,611.7
Chennai,Ranchi,"13.0836939,80.270186","23.3700501,85.3250387",3492387,315279,303686,11593,5,3492.387
Chennai,Thiruvananthapuram,"13.0836939,80.270186","8.4882267,76.947551",951339,82824,56760,26064,8,951.339
Chennai,Tiruchirappalli,"13.0836939,80.270186","10.804973,78.6870296",334974,25051,18187,6864,2,334.974
Chennai,Tuticorin,"13.0836939,80.270186","8.8052602,78.1452745",616238,46985,31851,15134,4,616.238
Chennai,Udaipur,"13.0836939,80.270186","24.578721,73.6862571",2089029,162864,110253,52611,17,2089.029
Chennai,Vadodara,"13.0836939,80.270186","22.2973142,73.1942567",1722974,132225,90700,41525,13,1722.974
Chennai,Vijayawada,"13.0836939,80.270186","16.5087573,80.6185089",454960,33553,23343,10210,4,454.96
Chennai,Visakhapatnam,"13.0836939,80.270186","17.7231276,83.3012842",819744,64045,43387,20658,6,819.744
Coimbatore,Ahmedabad,"11.0018115,76.9628425","23.0216238,72.5797068",1881709,141600,95863,45737,15,1881.709
Coimbatore,Chennai,"11.0018115,76.9628425","13.0836939,80.270186",528994,40572,27027,13545,4,528.994
Coimbatore,Coimbatore,"11.0018115,76.9628425","11.0018115,76.9628425",0,0,0,0,0,0.0
Coimbatore,Delhi,"11.0018115,76.9628425","28.6273928,77.1716954",2796291,217132,143803,73329,23,2796.291
Coimbatore,Hyderabad,"11.0018115,76.9628425","17.360589,78.4740613",934504,68438,45741,22697,7,934.504
Coimbatore,Kochi,"11.0018115,76.9628425","9.9674277,76.2454436",193991,16832,13817,3015,1,193.991
Coimbatore,Kolkata,"11.0018115,76.9628425","22.5726459,88.3638953",3588800,319509,303802,15707,7,3588.8
Coimbatore,Mangalore,"11.0018115,76.9628425","12.8698101,74.8430082",410989,41130,31676,9454,4,410.989
Coimbatore,Mumbai,"11.0018115,76.9628425","19.08157715,72.88662753964906",1371400,104000,69903,34097,11,1371.4
Coimbatore,Pune,"11.0018115,76.9628425","18.521428,73.8544541",1225379,93842,61424,32418,10,1225.379
Dehradun,Ahmedabad,"30.3255646,78.0436813","23.0216238,72.5797068",1188901,95035,64897,30138,11,1188.901
Dehradun,Amritsar,"30.3255646,78.0436813","31.6343083,74.8736788",434953,30999,23202,7797,3,434.953
Dehradun,Delhi,"30.3255646,78.0436813","28.6273928,77.1716954",276069,20737,16430,4307,2,276.069
Dehradun,Hyderabad,"30.3255646,78.0436813","17.360589,78.4740613",2411869,190184,128343,61841,21,2411.869
Dehradun,Jaipur,"30.3255646,78.0436813","26.9154576,75.8189817",528346,37612,28687,8925,4,528.346
Dehradun,Jammu,"30.3255646,78.0436813","32.7185614,74.8580917",569279,41694,30042,11652,3,569.279
Dehradun,Kolkata,"30.3255646,78.0436813","22.5726459,88.3638953",5993441,505539,425245,80294,29,5993.441
Dehradun,Mumbai,"30.3255646,78.0436813","19.08157715,72.88662753964906",1702052,132072,89780,42292,14,1702.052
Dehradun,Pantnagar,"30.3255646,78.0436813","29.028405,79.4832094",414651,32556,22957,9599,3,414.651
Delhi,Agra,"28.6273928,77.1716954","27.1752554,78.0098161",220570,15604,12391,3213,1,220.57
Delhi,Ahmedabad,"28.6273928,77.1716954","23.0216238,72.5797068",998350,79225,54767,24458,7,998.35
Delhi,Amritsar,"28.6273928,77.1716954","31.6343083,74.8736788",464132,33435,24944,8491,4,464.132
Delhi,Bhatinda,"28.6273928,77.1716954","30.25,75.0",372045,27910,19783,8127,2,372.045
Delhi,Bhubaneswar,"28.6273928,77.1716954","20.2602964,85.8394521",6302585,538309,450835,87474,30,6302.585
Delhi,Calicut,"28.6273928,77.1716954","11.2450558,75.7754716",2738554,227301,152398,74903,20,2738.554
Delhi,Chandigarh,"28.6273928,77.1716954","30.7334421,76.7797143",253992,19679,16148,3531,2,253.992
Delhi,Chennai,"28.6273928,77.1716954","13.0836939,80.270186",2759452,218502,146071,72431,22,2759.452
Delhi,Coimbatore,"28.6273928,77.1716954","11.0018115,76.9628425",2800442,218283,144967,73316,22,2800.442
Delhi,Dehradun,"28.6273928,77.1716954","30.3255646,78.0436813",272998,21805,16840,4965,2,272.998
Delhi,Goa,"28.6273928,77.1716954","15.3004543,74.0855134",2027064,162230,112277,49953,16,2027.064
Delhi,Gwalior,"28.6273928,77.1716954","26.2037247,78.1573628",327941,24801,19630,5171,2,327.941
Delhi,Hyderabad,"28.6273928,77.1716954","17.360589,78.4740613",2244498,175770,120920,54850,18,2244.498
Delhi,Jaipur,"28.6273928,77.1716954","26.9154576,75.8189817",262341,19736,16489,3247,1,262.341
Delhi,Jammu,"28.6273928,77.1716954","32.7185614,74.8580917",598458,44187,31838,12349,4,598.458
Delhi,Jodhpur,"28.6273928,77.1716954","26.2967719,73.0351433",707008,55042,40922,14120,5,707.008
Delhi,Kannur,"28.6273928,77.1716954","11.8763836,75.3737973",2684902,217343,145276,72067,21,2684.902
Delhi,Kochi,"28.6273928,77.1716954","9.9674277,76.2454436",2996633,233423,156113,77310,23,2996.633
Delhi,Kolkata,"28.6273928,77.1716954","22.5726459,88.3638953",5727968,485604,412053,73551,25,5727.968
Delhi,Ludhiana,"28.6273928,77.1716954","30.9090157,75.851601",318679,22999,18536,4463,2,318.679
Delhi,Madurai,"28.6273928,77.1716954","9.9261153,78.1140983",2916807,230475,153468,77007,23,2916.807
Delhi,Mangalore,"28.6273928,77.1716954","12.8698101,74.8430082",2461560,206053,136168,69885,19,2461.56
Delhi,Mumbai,"28.6273928,77.1716954","19.08157715,72.88662753964906",1534618,119383,83678,35705,11,1534.618
Delhi,Nagpur,"28.6273928,77.1716954","21.1498134,79.0820556",2690385,210683,142423,68260,20,2690.385
Delhi,Pantnagar,"28.6273928,77.1716954","29.028405,79.4832094",267254,22385,15492,6893,2,267.254
Delhi,Port Blair,"28.6273928,77.1716954","11.6645348,92.7390448",4291906,352309,279451,72858,25,4291.906
Delhi,Pune,"28.6273928,77.1716954","18.521428,73.8544541",1676185,129019,91403,37616,12,1676.185
Delhi,Raipur,"28.6273928,77.1716954","21.2380912,81.6336993",2977935,235080,158677,76403,22,2977.935
Delhi,Rajkot,"28.6273928,77.1716954","22.3053263,70.8028377",1210801,95867,67612,28255,8,1210.801
Delhi,Ranchi,"28.6273928,77.1716954","23.3700501,85.3250387",6263114,532973,447131,85842,29,6263.114
Delhi,Shimla,"28.6273928,77.1716954","31.1041526,77.1709729",358385,32151,24378,7773,3,358.385
Delhi,Tirupati,"28.6273928,77.1716954","13.6316368,79.4231711",2780339,216423,147476,68947,21,2780.339
Delhi,Udaipur,"28.6273928,77.1716954","24.578721,73.6862571",666916,51549,36754,14795,4,666.916
Delhi,Vadodara,"28.6273928,77.1716954","22.2973142,73.1942567",1025283,85045,57403,27642,7,1025.283
Delhi,Vijayawada,"28.6273928,77.1716954","16.5087573,80.6185089",2536834,196308,135031,61277,20,2536.834
Delhi,Visakhapatnam,"28.6273928,77.1716954","17.7231276,83.3012842",2904402,226053,154404,71649,23,2904.402
Dibrugarh,Dimapur,"27.4844597,94.9019447","25.911744,93.721703",274382,29314,23211,6103,2,274.382
Dibrugarh,Jorhat,"27.4844597,94.9019447","26.7577925,94.2079645",137265,13291,11864,1427,1,137.265
Goa,Ahmedabad,"15.3004543,74.0855134","23.0216238,72.5797068",1153767,90842,64664,26178,8,1153.767
Goa,Amritsar,"15.3004543,74.0855134","31.6343083,74.8736788",2522273,197204,136446,60758,18,2522.273
Goa,Bengaluru,"15.3004543,74.0855134","12.9767936,77.590082",613010,54499,34922,19577,6,613.01
Goa,Chandigarh,"15.3004543,74.0855134","30.7334421,76.7797143",2312095,182844,126363,56481,17,2312.095
Goa,Chennai,"15.3004543,74.0855134","13.0836939,80.270186",941929,80988,54980,26008,7,941.929
Goa,Delhi,"15.3004543,74.0855134","28.6273928,77.1716954",2068251,166892,115134,51758,15,2068.251
Goa,Hubli,"15.3004543,74.0855134","15.3518378,75.1379848",271724,24447,19336,5111,2,271.724
Goa,Hyderabad,"15.3004543,74.0855134","17.360589,78.4740613",788877,69433,47652,21781,6,788.877
Goa,Kannur,"15.3004543,74.0855134","11.8763836,75.3737973",871623,81166,54474,26692,7,871.623
Goa,Kochi,"15.3004543,74.0855134","9.9674277,76.2454436",1179251,99518,67229,32289,10,1179.251
Goa,Kolkata,"15.3004543,74.0855134","22.5726459,88.3638953",4001678,360690,332094,28596,10,4001.678
Goa,Mumbai,"15.3004543,74.0855134","19.08157715,72.88662753964906",637334,50225,36657,13568,4,637.334
Goa,Mysore,"15.3004543,74.0855134","12.3051828,76.6553609",712557,61395,39594,21801,5,712.557
Goa,Nagpur,"15.3004543,74.0855134","21.1498134,79.0820556",1228610,105559,69202,36357,8,1228.61
Goa,Pune,"15.3004543,74.0855134","18.521428,73.8544541",493000,40121,29470,10651,3,493.0
Guwahati,Tezpur,"26.1805978,91.753943","26.61695705,92.76500717365028",188641,15395,12755,2640,1,188.641
Hubli,Ahmedabad,"15.3518378,75.1379848","23.0216238,72.5797068",1088986,82045,56742,25303,8,1088.986
Hubli,Chennai,"15.3518378,75.1379848","13.0836939,80.270186",757601,58572,38693,19879,6,757.601
Hubli,Goa,"15.3518378,75.1379848","15.3004543,74.0855134",157343,15695,13481,2214,1,157.343
Hubli,Hyderabad,"15.3518378,75.1379848","17.360589,78.4740613",724846,61371,39407,21964,6,724.846
Hubli,Kannur,"15.3518378,75.1379848","11.8763836,75.3737973",682794,57500,38332,19168,5,682.794
Hubli,Kochi,"15.3518378,75.1379848","9.9674277,76.2454436",994810,76166,50515,25651,8,994.81
Hubli,Mangalore,"15.3518378,75.1379848","12.8698101,74.8430082",459753,46909,29387,17522,3,459.753
Hubli,Mumbai,"15.3518378,75.1379848","19.08157715,72.88662753964906",572553,42383,29579,12804,4,572.553
Hubli,Tirupati,"15.3518378,75.1379848","13.6316368,79.4231711",671467,49122,31732,17390,6,671.467
Hyderabad,Ahmedabad,"17.360589,78.4740613","23.0216238,72.5797068",1243662,97689,67970,29719,11,1243.662
Hyderabad,Amritsar,"17.360589,78.4740613","31.6343083,74.8736788",2608022,202393,139410,62983,21,2608.022
Hyderabad,Belgaum,"17.360589,78.4740613","15.8572666,74.5069343",634833,51118,35611,15507,5,634.833
Hyderabad,Bhubaneswar,"17.360589,78.4740613","20.2602964,85.8394521",4042329,362828,331525,31303,12,4042.329
Hyderabad,Calicut,"17.360589,78.4740613","11.2450558,75.7754716",973011,78916,57181,21735,7,973.011
Hyderabad,Chandigarh,"17.360589,78.4740613","30.7334421,76.7797143",2398059,188705,129945,58760,20,2398.059
Hyderabad,Chennai,"17.360589,78.4740613","13.0836939,80.270186",630480,48449,33128,15321,5,630.48
Hyderabad,Coimbatore,"17.360589,78.4740613","11.0018115,76.9628425",953056,69137,48565,20572,7,953.056
Hyderabad,Dehradun,"17.360589,78.4740613","30.3255646,78.0436813",2423949,193397,134393,59004,21,2423.949
Hyderabad,Delhi,"17.360589,78.4740613","28.6273928,77.1716954",2152882,172958,118913,54045,18,2152.882
Hyderabad,Goa,"17.360589,78.4740613","15.3004543,74.0855134",748241,64861,45641,19220,6,748.241
Hyderabad,Gwalior,"17.360589,78.4740613","26.2037247,78.1573628",2408437,190791,130720,60071,20,2408.437
Hyderabad,Hubli,"17.360589,78.4740613","15.3518378,75.1379848",613202,51109,35538,15571,5,613.202
Hyderabad,Jaipur,"17.360589,78.4740613","26.9154576,75.8189817",1895971,152833,102905,49928,16,1895.971
Hyderabad,Jammu,"17.360589,78.4740613","32.7185614,74.8580917",2742337,213077,146240,66837,21,2742.337
Hyderabad,Kadapa,"17.360589,78.4740613","14.4752936,78.8216861",423271,29009,21934,7075,3,423.271
Hyderabad,Kannur,"17.360589,78.4740613","11.8763836,75.3737973",905049,71169,51064,20105,7,905.049
Hyderabad,Kochi,"17.360589,78.4740613","9.9674277,76.2454436",1149275,86410,61338,25072,9,1149.275
Hyderabad,Kolhapur,"17.360589,78.4740613","16.7028412,74.2405329",557264,44811,30812,13999,5,557.264
Hyderabad,Kolkata,"17.360589,78.4740613","22.5726459,88.3638953",3571381,316502,298752,17750,8,3571.381
Hyderabad,Madurai,"17.360589,78.4740613","9.9261153,78.1140983",1069438,81452,57493,23959,8,1069.438
Hyderabad,Mangalore,"17.360589,78.4740613","12.8698101,74.8430082",973604,78942,54671,24271,7,973.604
Hyderabad,Mumbai,"17.360589,78.4740613","19.08157715,72.88662753964906",727218,56125,39091,17034,7,727.218
Hyderabad,Mysore,"17.360589,78.4740613","12.3051828,76.6553609",721032,50270,35948,14322,5,721.032
Hyderabad,Nagpur,"17.360589,78.4740613","21.1498134,79.0820556",509859,39555,27266,12289,4,509.859
Hyderabad,Pondicherry,"17.360589,78.4740613","10.91564885,79.80694879844232",923731,78056,53170,24886,7,923.731
Hyderabad,Port Blair,"17.360589,78.4740613","11.6645348,92.7390448",2032027,176377,159725,16652,7,2032.027
Hyderabad,Pune,"17.360589,78.4740613","18.521428,73.8544541",578011,45018,30197,14821,6,578.011
Hyderabad,Raipur,"17.360589,78.4740613","21.2380912,81.6336993",797719,63611,43448,20163,5,797.719
Hyderabad,Rajahmundry,"17.360589,78.4740613","17.0050454,81.7804732",434103,32220,23018,9202,4,434.103
Hyderabad,Ranchi,"17.360589,78.4740613","23.3700501,85.3250387",4002819,357151,327545,29606,11,4002.819
Hyderabad,Thiruvananthapuram,"17.360589,78.4740613","8.4882267,76.947551",1360585,110426,77855,32571,11,1360.585
Hyderabad,Tiruchirappalli,"17.360589,78.4740613","10.804973,78.6870296",926757,68894,49306,19588,7,926.757
Hyderabad,Tirupati,"17.360589,78.4740613","13.6316368,79.4231711",564026,41258,30191,11067,4,564.026
Hyderabad,Tuticorin,"17.360589,78.4740613","8.8052602,78.1452745",1218965,95133,66292,28841,9,1218.965
Hyderabad,Udaipur,"17.360589,78.4740613","24.578721,73.6862571",1496479,116603,81190,35413,12,1496.479
Hyderabad,Vadodara,"17.360589,78.4740613","22.2973142,73.1942567",1129286,87936,62483,25453,10,1129.286
Hyderabad,Vijayawada,"17.360589,78.4740613","16.5087573,80.6185089",274199,20258,15053,5205,3,274.199
Hyderabad,Visakhapatnam,"17.360589,78.4740613","17.7231276,83.3012842",642520,49765,34658,15107,4,642.52
Indore,Ahmedabad,"22.7203616,75.8681996","23.0216238,72.5797068",401330,32794,24338,8456,3,401.33
Indore,Belgaum,"22.7203616,75.8681996","15.8572666,74.5069343",1230674,91263,66759,24504,9,1230.674
Indore,Chandigarh,"22.7203616,75.8681996","30.7334421,76.7797143",1547479,124052,84554,39498,12,1547.479
Indore,Chennai,"22.7203616,75.8681996","13.0836939,80.270186",2073703,160758,110213,50545,16,2073.703
Indore,Delhi,"22.7203616,75.8681996","28.6273928,77.1716954",1302693,109945,75348,34597,11,1302.693
Indore,Goa,"22.7203616,75.8681996","15.3004543,74.0855134",1344404,104544,76702,27842,10,1344.404
Indore,Gwalior,"22.7203616,75.8681996","26.2037247,78.1573628",1558229,126029,85931,40098,13,1558.229
Indore,Hyderabad,"22.7203616,75.8681996","17.360589,78.4740613",1463340,113619,78754,34865,12,1463.34
Indore,Jaipur,"22.7203616,75.8681996","26.9154576,75.8189817",1045784,91042,60212,30830,9,1045.784
Indore,Jodhpur,"22.7203616,75.8681996","26.2967719,73.0351433",872871,68024,48500,19524,6,872.871
Indore,Kochi,"22.7203616,75.8681996","9.9674277,76.2454436",2311758,179719,122739,56980,19,2311.758
Indore,Kolkata,"22.7203616,75.8681996","22.5726459,88.3638953",5044058,429889,376303,53586,20,5044.058
Indore,Mumbai,"22.7203616,75.8681996","19.08157715,72.88662753964906",760646,57230,40958,16272,6,760.646
Indore,Nagpur,"22.7203616,75.8681996","21.1498134,79.0820556",1903073,147351,99642,47709,14,1903.073
Indore,Pune,"22.7203616,75.8681996","18.521428,73.8544541",895003,66549,49233,17316,6,895.003
Indore,Raipur,"22.7203616,75.8681996","21.2380912,81.6336993",2190607,173347,116862,56485,16,2190.607
Indore,Rajkot,"22.7203616,75.8681996","22.3053263,70.8028377",629623,45056,33439,11617,4,629.623
Indore,Udaipur,"22.7203616,75.8681996","24.578721,73.6862571",646065,52956,37070,15886,5,646.065
Indore,Vadodara,"22.7203616,75.8681996","22.2973142,73.1942567",347524,30897,20451,10446,3,347.524
Jabalpur,Ahmedabad,"23.1608938,79.9497702","23.0216238,72.5797068",949022,84527,57111,27416,6,949.022
Jaipur,Agra,"26.9154576,75.8189817","27.1752554,78.0098161",401955,27906,21669,6237,2,401.955
Jaipur,Ahmedabad,"26.9154576,75.8189817","23.0216238,72.5797068",664884,56329,37432,18897,6,664.884
Jaipur,Amritsar,"26.9154576,75.8189817","31.6343083,74.8736788",713858,47515,35275,12240,4,713.858
Jaipur,Bengaluru,"26.9154576,75.8189817","12.9767936,77.590082",2160399,177076,116364,60712,19,2160.399
Jaipur,Chandigarh,"26.9154576,75.8189817","30.7334421,76.7797143",503596,34133,25798,8335,2,503.596
Jaipur,Chennai,"26.9154576,75.8189817","13.0836939,80.270186",2497257,203893,135621,68272,21,2497.257
Jaipur,Dehradun,"26.9154576,75.8189817","30.3255646,78.0436813",528250,37300,28951,8349,4,528.25
Jaipur,Delhi,"26.9154576,75.8189817","28.6273928,77.1716954",258755,19852,16846,3006,1,258.755
Jaipur,Hyderabad,"26.9154576,75.8189817","17.360589,78.4740613",1884245,153599,103389,50210,16,1884.245
Jaipur,Kochi,"26.9154576,75.8189817","9.9674277,76.2454436",2734812,217942,144530,73412,22,2734.812
Jaipur,Kolkata,"26.9154576,75.8189817","22.5726459,88.3638953",5464829,470148,401267,68881,24,5464.829
Jaipur,Mumbai,"26.9154576,75.8189817","19.08157715,72.88662753964906",1178011,99138,66673,32465,10,1178.011
Jaipur,Pune,"26.9154576,75.8189817","18.521428,73.8544541",1315050,111145,75703,35442,11,1315.05
Jaipur,Udaipur,"26.9154576,75.8189817","24.578721,73.6862571",408891,33688,23469,10219,3,408.891
Jaipur,Vadodara,"26.9154576,75.8189817","22.2973142,73.1942567",763497,64869,42620,22249,7,763.497
Jammu,Ahmedabad,"32.7185614,74.8580917","23.0216238,72.5797068",1522734,118177,79164,39013,12,1522.734
Jammu,Bhatinda,"32.7185614,74.8580917","30.25,75.0",400671,32281,23495,8786,2,400.671
Jammu,Chandigarh,"32.7185614,74.8580917","30.7334421,76.7797143",372215,28633,20837,7796,2,372.215
Jammu,Dehradun,"32.7185614,74.8580917","30.3255646,78.0436813",594378,42783,30469,12314,3,594.378
Jammu,Delhi,"32.7185614,74.8580917","28.6273928,77.1716954",603393,43063,30749,12314,3,603.393
Jammu,Gwalior,"32.7185614,74.8580917","26.2037247,78.1573628",957113,67259,47562,19697,6,957.113
Jammu,Mumbai,"32.7185614,74.8580917","19.08157715,72.88662753964906",2035925,158100,105809,52291,15,2035.925
Jodhpur,Ahmedabad,"26.2967719,73.0351433","23.0216238,72.5797068",454161,33876,23391,10485,3,454.161
Jodhpur,Bengaluru,"26.2967719,73.0351433","12.9767936,77.590082",1959620,150562,100709,49853,15,1959.62
Jodhpur,Chennai,"26.2967719,73.0351433","13.0836939,80.270186",2296475,180196,122668,57528,17,2296.475
Jodhpur,Delhi,"26.2967719,73.0351433","28.6273928,77.1716954",688309,53857,37501,16356,5,688.309
Jodhpur,Mumbai,"26.2967719,73.0351433","19.08157715,72.88662753964906",978119,74311,51286,23025,6,978.119
Jodhpur,Pune,"26.2967719,73.0351433","18.521428,73.8544541",1116735,84991,60106,24885,7,1116.735
Jorhat,Dibrugarh,"26.7577925,94.2079645","27.4844597,94.9019447",137219,13431,11829,1602,1,137.219
Jorhat,Tezpur,"26.7577925,94.2079645","26.61695705,92.76500717365028",171322,15088,12641,2447,1,171.322
Kadapa,Belgaum,"14.4752936,78.8216861","15.8572666,74.5069343",700392,64392,40091,24301,5,700.392
Kadapa,Chennai,"14.4752936,78.8216861","13.0836939,80.270186",258222,23303,17968,5335,2,258.222
Kadapa,Hyderabad,"14.4752936,78.8216861","17.360589,78.4740613",414745,28264,20122,8142,3,414.745
Kadapa,Vijayawada,"14.4752936,78.8216861","16.5087573,80.6185089",469255,35631,24675,10956,3,469.255
Kannur,Ahmedabad,"11.8763836,75.3737973","23.0216238,72.5797068",1786102,142948,96693,46255,14,1786.102
Kannur,Calicut,"11.8763836,75.3737973","11.2450558,75.7754716",91357,8822,8822,0,0,91.357
Kannur,Chennai,"11.8763836,75.3737973","13.0836939,80.270186",678294,57266,40100,17166,6,678.294
Kannur,Delhi,"11.8763836,75.3737973","28.6273928,77.1716954",2700684,218407,144569,73838,22,2700.684
Kannur,Goa,"11.8763836,75.3737973","15.3004543,74.0855134",918961,82401,55366,27035,8,918.961
Kannur,Hubli,"11.8763836,75.3737973","15.3518378,75.1379848",694934,57747,38152,19595,6,694.934
Kannur,Hyderabad,"11.8763836,75.3737973","17.360589,78.4740613",907752,70612,48764,21848,7,907.752
Kannur,Kochi,"11.8763836,75.3737973","9.9674277,76.2454436",282503,28956,23910,5046,2,282.503
Kannur,Kolkata,"11.8763836,75.3737973","22.5726459,88.3638953",3738100,336830,317142,19688,9,3738.1
Kannur,Mumbai,"11.8763836,75.3737973","19.08157715,72.88662753964906",1271599,105466,70825,34641,10,1271.599
Kannur,Thiruvananthapuram,"11.8763836,75.3737973","8.4882267,76.947551",468877,44404,34143,10261,2,468.877
Keshod,Ahmedabad,"21.31486295,70.26789366226589","23.0216238,72.5797068",356608,29242,22327,6915,2,356.608
Kochi,Ahmedabad,"9.9674277,76.2454436","23.0216238,72.5797068",2086769,161628,107490,54138,17,2086.769
Kochi,Bhubaneswar,"9.9674277,76.2454436","20.2602964,85.8394521",4256540,380574,346469,34105,12,4256.54
Kochi,Calicut,"9.9674277,76.2454436","11.2450558,75.7754716",187140,20110,16809,3301,1,187.14
Kochi,Chennai,"9.9674277,76.2454436","13.0836939,80.270186",729617,58520,39359,19161,6,729.617
Kochi,Coimbatore,"9.9674277,76.2454436","11.0018115,76.9628425",198996,18477,14050,4427,2,198.996
Kochi,Delhi,"9.9674277,76.2454436","28.6273928,77.1716954",3000094,238826,157619,81207,25,3000.094
Kochi,Goa,"9.9674277,76.2454436","15.3004543,74.0855134",1155042,96464,64118,32346,10,1155.042
Kochi,Hubli,"9.9674277,76.2454436","15.3518378,75.1379848",999032,77545,50849,26696,9,999.032
Kochi,Hyderabad,"9.9674277,76.2454436","17.360589,78.4740613",1135032,85892,58382,27510,9,1135.032
Kochi,Jaipur,"9.9674277,76.2454436","26.9154576,75.8189817",2732040,218005,141528,76477,23,2732.04
Kochi,Kannur,"9.9674277,76.2454436","11.8763836,75.3737973",279519,28821,23487,5334,2,279.519
Kochi,Kolkata,"9.9674277,76.2454436","22.5726459,88.3638953",3789423,338109,316410,21699,9,3789.423
Kochi,Madurai,"9.9674277,76.2454436","9.9261153,78.1140983",419608,34532,25895,8637,3,419.608
Kochi,Mangalore,"9.9674277,76.2454436","12.8698101,74.8430082",417930,41710,32728,8982,3,417.93
Kochi,Mumbai,"9.9674277,76.2454436","19.08157715,72.88662753964906",1570336,122717,81040,41677,13,1570.336
Kochi,Mysore,"9.9674277,76.2454436","12.3051828,76.6553609",436075,44454,34343,10111,3,436.075
Kochi,Nagpur,"9.9674277,76.2454436","21.1498134,79.0820556",1649021,123925,83924,40001,12,1649.021
Kochi,Pune,"9.9674277,76.2454436","18.521428,73.8544541",1426002,113027,73908,39119,12,1426.002
Kochi,Thiruvananthapuram,"9.9674277,76.2454436","8.4882267,76.947551",258003,26813,20629,6184,2,258.003
Kochi,Tiruchirappalli,"9.9674277,76.2454436","10.804973,78.6870296",418945,34999,26362,8637,3,418.945
Kochi,Tirupati,"9.9674277,76.2454436","13.6316368,79.4231711",701680,54793,36935,17858,6,701.68
Kochi,Visakhapatnam,"9.9674277,76.2454436","17.7231276,83.3012842",1487626,121896,80506,41390,12,1487.626
Kolhapur,Hyderabad,"16.7028412,74.2405329","17.360589,78.4740613",558489,43954,29565,14389,4,558.489
Kolhapur,Mumbai,"16.7028412,74.2405329","19.08157715,72.88662753964906",379401,28891,21451,7440,3,379.401
Kolhapur,Tirupati,"16.7028412,74.2405329","13.6316368,79.4231711",875923,67473,43864,23609,8,875.923
Kolkata,Ahmedabad,"22.5726459,88.3638953","23.0216238,72.5797068",4825498,414958,366080,48878,18,4825.498
Kolkata,Amritsar,"22.5726459,88.3638953","31.6343083,74.8736788",6195379,519902,435747,84155,29,6195.379
Kolkata,Bengaluru,"22.5726459,88.3638953","12.9767936,77.590082",3396478,304893,296076,8817,4,3396.478
Kolkata,Bhubaneswar,"22.5726459,88.3638953","20.2602964,85.8394521",480005,42555,31432,11123,4,480.005
Kolkata,Chandigarh,"22.5726459,88.3638953","30.7334421,76.7797143",5978933,506449,424898,81551,28,5978.933
Kolkata,Chennai,"22.5726459,88.3638953","13.0836939,80.270186",3060195,278389,277189,1200,2,3060.195
Kolkata,Dehradun,"22.5726459,88.3638953","30.3255646,78.0436813",6001296,508435,428919,79516,28,6001.296
Kolkata,Delhi,"22.5726459,88.3638953","28.6273928,77.1716954",5740101,487427,413169,74258,26,5740.101
Kolkata,Goa,"22.5726459,88.3638953","15.3004543,74.0855134",3967992,355815,329170,26645,9,3967.992
Kolkata,Gwalior,"22.5726459,88.3638953","26.2037247,78.1573628",5995637,507237,426868,80369,28,5995.637
Kolkata,Hyderabad,"22.5726459,88.3638953","17.360589,78.4740613",3566016,316220,298827,17393,7,3566.016
Kolkata,Jaipur,"22.5726459,88.3638953","26.9154576,75.8189817",5477958,469190,399778,69412,24,5477.958
Kolkata,Kannur,"22.5726459,88.3638953","11.8763836,75.3737973",3720736,335696,319387,16309,7,3720.736
Kolkata,Kochi,"22.5726459,88.3638953","9.9674277,76.2454436",3792883,338533,317877,20656,8,3792.883
Kolkata,Mumbai,"22.5726459,88.3638953","19.08157715,72.88662753964906",4310154,375436,338811,36625,14,4310.154
Kolkata,Nagpur,"22.5726459,88.3638953","21.1498134,79.0820556",4065340,355526,322702,32824,10,4065.34
Kolkata,Port Blair,"22.5726459,88.3638953","11.6645348,92.7390448",1543663,140613,140013,600,1,1543.663
Kolkata,Pune,"22.5726459,88.3638953","18.521428,73.8544541",4160677,364773,330133,34640,13,4160.677
Kolkata,Raipur,"22.5726459,88.3638953","21.2380912,81.6336993",4352873,379552,338450,41102,12,4352.873
Kolkata,Ranchi,"22.5726459,88.3638953","23.3700501,85.3250387",443471,39313,28741,10572,3,443.471
Kolkata,Vadodara,"22.5726459,88.3638953","22.2973142,73.1942567",4712072,404094,359117,44977,17,4712.072
Kolkata,Visakhapatnam,"22.5726459,88.3638953","17.7231276,83.3012842",2925986,265928,264728,1200,2,2925.986
Lucknow,Allahabad,"26.8381,80.9346001","25.4381302,81.8338005",202353,16120,13456,2664,1,202.353
Lucknow,Lucknow,"26.8381,80.9346001","26.8381,80.9346001",0,0,0,0,0,0.0
Ludhiana,Delhi,"30.9090157,75.851601","28.6273928,77.1716954",318715,23591,17781,5810,2,318.715
Madurai,Chennai,"9.9261153,78.1140983","13.0836939,80.270186",477668,36312,24306,12006,3,477.668
Madurai,Delhi,"9.9261153,78.1140983","28.6273928,77.1716954",2926428,232376,153185,79191,23,2926.428
Madurai,Hyderabad,"9.9261153,78.1140983","17.360589,78.4740613",1060304,82620,55148,27472,8,1060.304
Madurai,Mumbai,"9.9261153,78.1140983","19.08157715,72.88662753964906",1495513,119826,78201,41625,12,1495.513
Mangalore,Chennai,"12.8698101,74.8430082","13.0836939,80.270186",737074,66146,46824,19322,5,737.074
Mangalore,Coimbatore,"12.8698101,74.8430082","11.0018115,76.9628425",415215,41565,32395,9170,4,415.215
Mangalore,Delhi,"12.8698101,74.8430082","28.6273928,77.1716954",2606901,225399,144661,80738,20,2606.901
Mangalore,Hubli,"12.8698101,74.8430082","15.3518378,75.1379848",605839,65657,39085,26572,4,605.839
Mangalore,Hyderabad,"12.8698101,74.8430082","17.360589,78.4740613",973253,79417,53732,25685,7,973.253
Mangalore,Kochi,"12.8698101,74.8430082","9.9674277,76.2454436",419109,41842,33214,8628,3,419.109
Mangalore,Mumbai,"12.8698101,74.8430082","19.08157715,72.88662753964906",1182175,113069,71217,41852,8,1182.175
Mangalore,Mysore,"12.8698101,74.8430082","12.3051828,76.6553609",255903,28194,18863,9331,2,255.903
Mangalore,Pune,"12.8698101,74.8430082","18.521428,73.8544541",1032481,102345,63297,39048,7,1032.481
Mumbai,Ahmedabad,"19.08157715,72.88662753964906","23.0216238,72.5797068",521096,40440,29165,11275,4,521.096
Mumbai,Amritsar,"19.08157715,72.88662753964906","31.6343083,74.8736788",1889577,146749,98622,48127,14,1889.577
Mumbai,Belgaum,"19.08157715,72.88662753964906","15.8572666,74.5069343",484958,35538,26023,9515,4,484.958
Mumbai,Bengaluru,"19.08157715,72.88662753964906","12.9767936,77.590082",992080,79026,51179,27847,9,992.08
Mumbai,Bhavnagar,"19.08157715,72.88662753964906","21.7718836,72.1416449",431308,37176,27643,9533,4,431.308
Mumbai,Bhubaneswar,"19.08157715,72.88662753964906","20.2602964,85.8394521",4770846,417342,367657,49685,18,4770.846
Mumbai,Calicut,"19.08157715,72.88662753964906","11.2450558,75.7754716",1209907,109740,71193,38547,9,1209.907
Mumbai,Chandigarh,"19.08157715,72.88662753964906","30.7334421,76.7797143",1673645,130825,87331,43494,12,1673.645
Mumbai,Chennai,"19.08157715,72.88662753964906","13.0836939,80.270186",1328938,107483,71986,35497,11,1328.938
Mumbai,Coimbatore,"19.08157715,72.88662753964906","11.0018115,76.9628425",1369116,107853,70884,36969,12,1369.116
Mumbai,Dehradun,"19.08157715,72.88662753964906","30.3255646,78.0436813",1699456,134507,90788,43719,13,1699.456
Mumbai,Delhi,"19.08157715,72.88662753964906","28.6273928,77.1716954",1428796,115885,77220,38665,11,1428.796
Mumbai,Goa,"19.08157715,72.88662753964906","15.3004543,74.0855134",598627,48790,35877,12913,5,598.627
Mumbai,Hubli,"19.08157715,72.88662753964906","15.3518378,75.1379848",580294,42201,30113,12088,5,580.294
Mumbai,Hyderabad,"19.08157715,72.88662753964906","17.360589,78.4740613",718937,56125,38568,17557,6,718.937
Mumbai,Jaipur,"19.08157715,72.88662753964906","26.9154576,75.8189817",1166653,97799,64110,33689,9,1166.653
Mumbai,Jammu,"19.08157715,72.88662753964906","32.7185614,74.8580917",2020254,157047,105159,51888,15,2020.254
Mumbai,Jodhpur,"19.08157715,72.88662753964906","26.2967719,73.0351433",992537,76402,53877,22525,7,992.537
Mumbai,Kannur,"19.08157715,72.88662753964906","11.8763836,75.3737973",1257752,106628,70512,36116,11,1257.752
Mumbai,Kochi,"19.08157715,72.88662753964906","9.9674277,76.2454436",1565825,122308,80460,41848,12,1565.825
Mumbai,Kolhapur,"19.08157715,72.88662753964906","16.7028412,74.2405329",377628,28407,21356,7051,3,377.628
Mumbai,Kolkata,"19.08157715,72.88662753964906","22.5726459,88.3638953",4298835,373240,336997,36243,14,4298.835
Mumbai,Madurai,"19.08157715,72.88662753964906","9.9261153,78.1140983",1486019,119860,78506,41354,12,1486.019
Mumbai,Mangalore,"19.08157715,72.88662753964906","12.8698101,74.8430082",1030465,91880,59473,32407,8,1030.465
Mumbai,Nagpur,"19.08157715,72.88662753964906","21.1498134,79.0820556",1152852,92138,61611,30527,8,1152.852
Mumbai,Porbandar,"19.08157715,72.88662753964906","21.6409,69.611",937316,71579,51464,20115,6,937.316
Mumbai,Port Blair,"19.08157715,72.88662753964906","11.6645348,92.7390448",2760470,233507,197958,35549,13,2760.47
Mumbai,Pune,"19.08157715,72.88662753964906","18.521428,73.8544541",150739,13133,10766,2367,1,150.739
Mumbai,Raipur,"19.08157715,72.88662753964906","21.2380912,81.6336993",1440385,116262,77395,38867,10,1440.385
Mumbai,Rajkot,"19.08157715,72.88662753964906","22.3053263,70.8028377",703727,51277,37248,14029,5,703.727
Mumbai,Ranchi,"19.08157715,72.88662753964906","23.3700501,85.3250387",4731639,411354,363358,47996,17,4731.639
Mumbai,Thiruvananthapuram,"19.08157715,72.88662753964906","8.4882267,76.947551",1757017,138059,91097,46962,13,1757.017
Mumbai,Tirupati,"19.08157715,72.88662753964906","13.6316368,79.4231711",1249633,96349,65211,31138,10,1249.633
Mumbai,Udaipur,"19.08157715,72.88662753964906","24.578721,73.6862571",767362,59867,40876,18991,5,767.362
Mumbai,Vadodara,"19.08157715,72.88662753964906","22.2973142,73.1942567",407272,31578,23062,8516,3,407.272
Mumbai,Visakhapatnam,"19.08157715,72.88662753964906","17.7231276,83.3012842",1372973,107387,72764,34623,11,1372.973
Mysore,Belgaum,"12.3051828,76.6553609","15.8572666,74.5069343",596718,46759,28856,17903,5,596.718
Mysore,Bengaluru,"12.3051828,76.6553609","12.9767936,77.590082",143250,10527,9257,1270,1,143.25
Mysore,Chennai,"12.3051828,76.6553609","13.0836939,80.270186",488059,37315,27123,10192,4,488.059
Mysore,Goa,"12.3051828,76.6553609","15.3004543,74.0855134",656701,54053,35885,18168,5,656.701
Mysore,Hyderabad,"12.3051828,76.6553609","17.360589,78.4740613",718318,49239,34668,14571,5,718.318
Mysore,Kochi,"12.3051828,76.6553609","9.9674277,76.2454436",440942,42924,33069,9855,3,440.942
Mysore,Mangalore,"12.3051828,76.6553609","12.8698101,74.8430082",256430,27074,18945,8129,2,256.43
Nagpur,Ahmedabad,"21.1498134,79.0820556","23.0216238,72.5797068",1678255,133652,88595,45057,12,1678.255
Nagpur,Bengaluru,"21.1498134,79.0820556","12.9767936,77.590082",1081993,80165,53999,26166,8,1081.993
Nagpur,Bhubaneswar,"21.1498134,79.0820556","20.2602964,85.8394521",4535298,399457,353198,46259,14,4535.298
Nagpur,Chennai,"21.1498134,79.0820556","13.0836939,80.270186",1133976,87885,57009,30876,8,1133.976
Nagpur,Delhi,"21.1498134,79.0820556","28.6273928,77.1716954",2586872,208687,136333,72354,19,2586.872
Nagpur,Goa,"21.1498134,79.0820556","15.3004543,74.0855134",1147413,103528,69578,33950,8,1147.413
Nagpur,Hyderabad,"21.1498134,79.0820556","17.360589,78.4740613",502570,38343,25778,12565,3,502.57
Nagpur,Kochi,"21.1498134,79.0820556","9.9674277,76.2454436",1642507,123639,83466,40173,11,1642.507
Nagpur,Kolkata,"21.1498134,79.0820556","22.5726459,88.3638953",4064585,356104,322514,33590,10,4064.585
Nagpur,Mumbai,"21.1498134,79.0820556","19.08157715,72.88662753964906",1171479,95550,62711,32839,9,1171.479
Nagpur,Pune,"21.1498134,79.0820556","18.521428,73.8544541",1018469,83209,52454,30755,7,1018.469
Nagpur,Ranchi,"21.1498134,79.0820556","23.3700501,85.3250387",4495788,394884,349662,45222,13,4495.788
Nagpur,Vadodara,"21.1498134,79.0820556","22.2973142,73.1942567",1564997,124736,82780,41956,11,1564.997
Pantnagar,Dehradun,"29.028405,79.4832094","30.3255646,78.0436813",385669,42756,26046,16710,3,385.669
Pantnagar,Delhi,"29.028405,79.4832094","28.6273928,77.1716954",311022,31102,18442,12660,2,311.022
Porbandar,Ahmedabad,"21.6409,69.611","23.0216238,72.5797068",424740,34225,25611,8614,2,424.74
Porbandar,Mumbai,"21.6409,69.611","19.08157715,72.88662753964906",909817,70314,50776,19538,5,909.817
Port Blair,Bengaluru,"11.6645348,92.7390448","12.9767936,77.590082",1856657,168697,160040,8657,4,1856.657
Port Blair,Chennai,"11.6645348,92.7390448","13.0836939,80.270186",1520922,138482,137882,600,1,1520.922
Port Blair,Delhi,"11.6645348,92.7390448","28.6273928,77.1716954",4198283,355780,279892,75888,24,4198.283
Port Blair,Hyderabad,"11.6645348,92.7390448","17.360589,78.4740613",2025154,178575,161431,17144,5,2025.154
Port Blair,Mumbai,"11.6645348,92.7390448","19.08157715,72.88662753964906",2780542,235965,199770,36195,12,2780.542
Port Blair,Visakhapatnam,"11.6645348,92.7390448","17.7231276,83.3012842",1386853,125943,125343,600,1,1386.853
Pune,Ahmedabad,"18.521428,73.8544541","23.0216238,72.5797068",658908,49036,36708,12328,5,658.908
Pune,Belgaum,"18.521428,73.8544541","15.8572666,74.5069343",339070,24893,18254,6639,2,339.07
Pune,Bengaluru,"18.521428,73.8544541","12.9767936,77.590082",846189,66671,42247,24424,7,846.189
Pune,Bhubaneswar,"18.521428,73.8544541","20.2602964,85.8394521",4616572,407058,357081,49977,18,4616.572
Pune,Chandigarh,"18.521428,73.8544541","30.7334421,76.7797143",1811457,138916,94305,44611,13,1811.457
Pune,Chennai,"18.521428,73.8544541","13.0836939,80.270186",1183047,96094,64015,32079,9,1183.047
Pune,Coimbatore,"18.521428,73.8544541","11.0018115,76.9628425",1224424,96470,62674,33796,9,1224.424
Pune,Delhi,"18.521428,73.8544541","28.6273928,77.1716954",1566608,123570,84027,39543,12,1566.608
Pune,Goa,"18.521428,73.8544541","15.3004543,74.0855134",452723,37862,28037,9825,3,452.723
Pune,Hyderabad,"18.521428,73.8544541","17.360589,78.4740613",568055,46003,28845,17158,6,568.055
Pune,Jaipur,"18.521428,73.8544541","26.9154576,75.8189817",1304465,105882,71216,34666,10,1304.465
Pune,Jodhpur,"18.521428,73.8544541","26.2967719,73.0351433",1130349,86269,62309,23960,8,1130.349
Pune,Kochi,"18.521428,73.8544541","9.9674277,76.2454436",1420643,111985,73760,38225,11,1420.643
Pune,Kolkata,"18.521428,73.8544541","22.5726459,88.3638953",4148873,363817,327621,36196,14,4148.873
Pune,Mangalore,"18.521428,73.8544541","12.8698101,74.8430082",884274,80073,51017,29056,6,884.274
Pune,Mumbai,"18.521428,73.8544541","19.08157715,72.88662753964906",149114,11660,10575,1085,1,149.114
Pune,Nagpur,"18.521428,73.8544541","21.1498134,79.0820556",1010381,81795,51716,30079,9,1010.381
Pune,Raipur,"18.521428,73.8544541","21.2380912,81.6336993",1297914,106946,68008,38938,11,1297.914
Raipur,Ahmedabad,"21.2380912,81.6336993","23.0216238,72.5797068",1968167,156867,103949,52918,15,1968.167
Raipur,Bhubaneswar,"21.2380912,81.6336993","20.2602964,85.8394521",4815978,424624,369709,54915,16,4815.978
Raipur,Chennai,"21.2380912,81.6336993","13.0836939,80.270186",1414231,112651,73118,39533,10,1414.231
Raipur,Delhi,"21.2380912,81.6336993","28.6273928,77.1716954",2882649,230463,152534,77929,22,2882.649
Raipur,Hyderabad,"21.2380912,81.6336993","17.360589,78.4740613",782825,63992,43015,20977,5,782.825
Raipur,Kolkata,"21.2380912,81.6336993","22.5726459,88.3638953",4344653,379779,338409,41370,12,4344.653
Raipur,Mumbai,"21.2380912,81.6336993","19.08157715,72.88662753964906",1451734,118159,77858,40301,11,1451.734
Raipur,Nagpur,"21.2380912,81.6336993","21.1498134,79.0820556",286865,23477,17743,5734,2,286.865
Raipur,Pune,"21.2380912,81.6336993","18.521428,73.8544541",1302257,107625,69192,38433,10,1302.257
Raipur,Ranchi,"21.2380912,81.6336993","23.3700501,85.3250387",4771390,419539,365452,54087,15,4771.39
Raipur,Visakhapatnam,"21.2380912,81.6336993","17.7231276,83.3012842",1417802,113804,74348,39456,9,1417.802
Rajahmundry,Bengaluru,"17.0050454,81.7804732","12.9767936,77.590082",822404,65323,43448,21875,5,822.404
Rajahmundry,Chennai,"17.0050454,81.7804732","13.0836939,80.270186",611017,46394,31569,14825,4,611.017
Rajahmundry,Hyderabad,"17.0050454,81.7804732","17.360589,78.4740613",437188,33543,22918,10625,4,437.188
Rajahmundry,Tirupati,"17.0050454,81.7804732","13.6316368,79.4231711",572203,44105,30270,13835,4,572.203
Rajahmundry,Visakhapatnam,"17.0050454,81.7804732","17.7231276,83.3012842",210844,15580,12357,3223,1,210.844
Rajkot,Delhi,"22.3053263,70.8028377","28.6273928,77.1716954",1134194,93014,65882,27132,9,1134.194
Rajkot,Mumbai,"22.3053263,70.8028377","19.08157715,72.88662753964906",701912,48597,35939,12658,4,701.912
Rajkot,Udaipur,"22.3053263,70.8028377","24.578721,73.6862571",477843,34634,27192,7442,3,477.843
Ranchi,Bengaluru,"23.3700501,85.3250387","12.9767936,77.590082",3833342,347460,326418,21042,7,3833.342
Ranchi,Bhubaneswar,"23.3700501,85.3250387","20.2602964,85.8394521",900365,83867,58887,24980,6,900.365
Ranchi,Chennai,"23.3700501,85.3250387","13.0836939,80.270186",3504215,318233,305032,13201,5,3504.215
Ranchi,Delhi,"23.3700501,85.3250387","28.6273928,77.1716954",6171916,533629,445829,87800,29,6171.916
Ranchi,Hyderabad,"23.3700501,85.3250387","17.360589,78.4740613",4010517,359608,329338,30270,10,4010.517
Ranchi,Kolkata,"23.3700501,85.3250387","22.5726459,88.3638953",447357,39907,29289,10618,3,447.357
Ranchi,Mumbai,"23.3700501,85.3250387","19.08157715,72.88662753964906",4754120,415681,367623,48058,16,4754.12
Ranchi,Raipur,"23.3700501,85.3250387","21.2380912,81.6336993",4798371,422907,369292,53615,16,4798.371
Shimla,Chandigarh,"31.1041526,77.1709729","30.7334421,76.7797143",112926,11802,10309,1493,1,112.926
Shimla,Delhi,"31.1041526,77.1709729","28.6273928,77.1716954",352625,28697,22331,6366,3,352.625
Thiruvananthapuram,Bengaluru,"8.4882267,76.947551","12.9767936,77.590082",779040,65847,45974,19873,6,779.04
Thiruvananthapuram,Chennai,"8.4882267,76.947551","13.0836939,80.270186",940367,81558,55130,26428,7,940.367
Thiruvananthapuram,Hyderabad,"8.4882267,76.947551","17.360589,78.4740613",1354868,108865,74619,34246,10,1354.868
Thiruvananthapuram,Kannur,"8.4882267,76.947551","11.8763836,75.3737973",512991,49896,37577,12319,4,512.991
Thiruvananthapuram,Kochi,"8.4882267,76.947551","9.9674277,76.2454436",259916,26279,20906,5373,2,259.916
Thiruvananthapuram,Mumbai,"8.4882267,76.947551","19.08157715,72.88662753964906",1775213,141925,92958,48967,13,1775.213
Tiruchirappalli,Chennai,"10.804973,78.6870296","13.0836939,80.270186",333352,24497,17609,6888,2,333.352
Tiruchirappalli,Hyderabad,"10.804973,78.6870296","17.360589,78.4740613",915988,69677,47438,22239,7,915.988
Tiruchirappalli,Kochi,"10.804973,78.6870296","9.9674277,76.2454436",514524,39391,28567,10824,3,514.524
Tiruchirappalli,Madurai,"10.804973,78.6870296","9.9261153,78.1140983",152476,10419,8839,1580,1,152.476
Tiruchirappalli,Tiruchirappalli,"10.804973,78.6870296","10.804973,78.6870296",0,0,0,0,0,0.0
Tirupati,Belgaum,"13.6316368,79.4231711","15.8572666,74.5069343",764583,58760,37277,21483,6,764.583
Tirupati,Delhi,"13.6316368,79.4231711","28.6273928,77.1716954",2660503,207048,137520,69528,20,2660.503
Tirupati,Hubli,"13.6316368,79.4231711","15.3518378,75.1379848",668725,48333,31555,16778,5,668.725
Tirupati,Hyderabad,"13.6316368,79.4231711","17.360589,78.4740613",554827,41715,29234,12481,4,554.827
Tirupati,Kochi,"13.6316368,79.4231711","9.9674277,76.2454436",702123,51906,35358,16548,4,702.123
Tirupati,Kolhapur,"13.6316368,79.4231711","16.7028412,74.2405329",870561,66137,42642,23495,7,870.561
Tirupati,Mumbai,"13.6316368,79.4231711","19.08157715,72.88662753964906",1241577,93881,63407,30474,9,1241.577
Tirupati,Rajahmundry,"13.6316368,79.4231711","17.0050454,81.7804732",570306,43303,29892,13411,4,570.306
Tirupati,Vijayawada,"13.6316368,79.4231711","16.5087573,80.6185089",413114,30960,21794,9166,3,413.114
Tirupati,Visakhapatnam,"13.6316368,79.4231711","17.7231276,83.3012842",778073,61648,42016,19632,5,778.073
Udaipur,Ahmedabad,"24.578721,73.6862571","23.0216238,72.5797068",255958,20219,14404,5815,2,255.958
Udaipur,Chennai,"24.578721,73.6862571","13.0836939,80.270186",2091144,164724,110517,54207,17,2091.144
Udaipur,Delhi,"24.578721,73.6862571","28.6273928,77.1716954",663398,50198,34633,15565,5,663.398
Udaipur,Hyderabad,"24.578721,73.6862571","17.360589,78.4740613",1480681,116384,78173,38211,13,1480.681
Udaipur,Jaipur,"24.578721,73.6862571","26.9154576,75.8189817",401255,32312,21589,10723,3,401.255
Udaipur,Mumbai,"24.578721,73.6862571","19.08157715,72.88662753964906",776224,58828,40217,18611,6,776.224
Udaipur,Rajkot,"24.578721,73.6862571","22.3053263,70.8028377",477831,35541,26318,9223,4,477.831
Vadodara,Chennai,"22.2973142,73.1942567","13.0836939,80.270186",1732514,133425,89979,43446,13,1732.514
Vadodara,Delhi,"22.2973142,73.1942567","28.6273928,77.1716954",1021106,84541,58367,26174,9,1021.106
Vadodara,Hyderabad,"22.2973142,73.1942567","17.360589,78.4740613",1120352,86983,60072,26911,9,1120.352
Vadodara,Jaipur,"22.2973142,73.1942567","26.9154576,75.8189817",764195,64251,42195,22056,7,764.195
Vadodara,Kolkata,"22.2973142,73.1942567","22.5726459,88.3638953",4707090,403457,357466,45991,17,4707.09
Vadodara,Mumbai,"22.2973142,73.1942567","19.08157715,72.88662753964906",410472,30554,22792,7762,2,410.472
Vadodara,Nagpur,"22.2973142,73.1942567","21.1498134,79.0820556",1566239,121913,81587,40326,11,1566.239
